7 7
#######
#P#...#
#.#.#.#
#.#.#.#
#.#.#.#
#.#.#.#
#..F..#