5 5
#####
#P..#
#.###
#..F#
#####

